11111111111111111111
1    12222  5  22221
1 3  122222222222221
1              22221
1        11111112221
122                1
1       7          1
1222211     11     1
1       6          1
1222           11111
1                  1
1         22  22   1
1                  1
1         222222   1
1                  1
12221111111        1
12222222222   1    1
12222222222   1  4 1
12222 5  22   1    1
11111111111111111111