11111111111111111111
1    1         22221
1 3  1         22221
1    1         22521
1          111122221
1                  1
1       7          1
1111111     11     1
1       6          1
1              11111
12222       22 2   1
1         22  22   1
12222              1
1         222  2   1
1                  1
122211             1
125222        1    1
122222        1  4 1
122221        1    1
11111111111111111111