111111111111111111111111111111111111111
1                  1 5 2          22221
1               3  1   2          22221
1                  1   2          22221
1            11111111111111111111112221
1                                     1
1                          7          1
1                                     1
1                                     1
1                 22                  1
1                 22                  1
1                 22                  1
1                 22                  1
1                 112                 1
1                 111                 1
1                 212                 1
1                 212                 1
1     222222222222222222222222        1
1     222222222222222222222222        1
1     222222222222222222222222        1
1              225 22                 1
1              22  22                 1
1       6      222222                 1
1              222222                 1
1     222222222222222222222222        1
1              212222                 1
1              211111                 1
1              22                     1
1              22                     1
1              22                     1
1              22                     1
1              12                     1
1                                     1
1                                     1
1                                     1
122211111111111111111111              1
12222     2   1                       1
12222     2   1    4                  1
12222     2 5 1                       1
111111111111111111111111111111111111111