11111111111111111111
1    1 5 2     22221
1 3   1   2    22221
1   2          22221
1        11111112221
1                  1
1       7          1
1111111     11     1
1       6          1
1    1112      11111
1         225 2    1
1         22  22   1
1         222222   1
1         222222   1
1                  1
122211             1
12222     2   1    1
12222     2   1  4 1
12222     2 5 1    1
11111111111111111111