11111111111111111111
1    122    5   2221
1 3  122        2221
1               2221
1        11111112221
122                1
1       7          1
1222211     11     1
1       6          1
12             11111
1   2       22222  1
1  2222       2    1
1  2          2    1
1  2        22222  1
1  2               1
1 2                1
1        22   1    1
12       22   1  4 1
12    5  22   1    1
11111111111111111111